1111111111111111111
1111111111111111111
1111111111111111011
1111111111111111111
1111111111111111111
1111111111111111111
1111111111111111111
1111111111111111111
0111111111111111111