11111111111111111111
1100001C010000001101
1011000001101000C101
10000010101001111101
11000010000C10010111
100001C00100000C0001
10010000000000011001
10010001100000011001
101000E000P0001C0001
10110001010000000011
11111111111111111111