111111111111111
111000001000001
100110000000001
101000000100CC1
11001C0C1000001
100111101000001
110000000010001
101001000011001
111000010011001
110C00100111011
110100000E00011
10P000000000001
111111111111111
111111111111111
111111111111111