1111111111111
101000000P001
101C1000E1001
1011111000001
1000000000011
1100100000001
1000000110011
10CC000100011
1111111111111