111111111111
100000001011
1C0001100001
1000001010P1
100010100E11
111111111111