11111111111111111
10000011011000001
10001001101000111
1100000C100010001
11001001100000101
11000010000C01001
1C010110000001C01
10110000000110001
100100110000C0001
101C000101100E001
10011100000011001
100010P0000000001
10000000010000001
10101C00001000001
11111111111111111