11111111111111111111
1100001C0100000011E1
1011000001101000C101
00000101010011111014
11000010000010010111
100001C00100000C0001
10010000000000011001
10010001100000011001
101000E000P000100001
10110001010000000011
11111111111111111111
