1111111111111111111
100000E000100001001
1000000000000000001
1000000000000101111
1101101100001110011
110C0000000010C1011
1010001010100000101
110100000000101C101
1101010010000010001
100110001000C000001
1110P000C0000010001
1100110000101000111
110000010100110CC01
1111111111111111111