11111111
10011001
11100111
1000E001
10001001
101C0101
10000001
10011101
101PC001
11000001
10000001
10000001
11111111
