11111111111111111111
11000000000100011101
101C0001000000010011
10010000010000001001
1011001000C001000001
11000100000001C00001
10E10000010000101001
10000000010000110011
100101001100C1000111
11C0010001000P000001
101000010010C10001C1
10000101010001001001
11111111111111111111