111111111111
101C000110C1
100010000001
101000010001
101000000001
1000C0011011
110E01000001
110100000001
110001011001
10000110P001
111100000101
111111111111