111111111111
110010000011
10000C0000C1
1100E0101001
100001111001
110000001001
1010100P0001
100000100001
100C10100101
111111111111